15
******************************
*............................*
*............................*
*.....*****.......*****......*
*............................*
*............................*
*............................*
*....*..................*....*
*.....*................*.....*
*......*..............*......*
*.......*............*.......*
*........***********.........*
*............................*
*............................*
******************************