29
*****************************************************************
*...............................................................*
*..............................*................................*
*..............................*................................*
*..............................*................................*
*..............................*................................*
*..............................*................................*
*........**************........*.........**************.........*
*..............................*................................*
*...............................................................*
*...............................................................*
*...............................................*...............*
*...............................................*...............*
*......................**************...........*...............*
*...............................................*...............*
*...............................................*...............*
*...............................................*...............*
*...............................................*...............*
*...............................................*...............*
*...............................................*...............*
*.......**************..............*...........................*
*...................................*...........................*
*...................................*...........................*
*...................................*...........................*
*...................................*...........................*
*...................................*...........................*
*...................................*...........................*
*...............................................................*
*****************************************************************