15
******************************
*............................*
*...***********************..*
*............................*
*..............******........*
*........***.................*
*.............*************..*
*....*****................*..*
*........*................*..*
*........**********.......*..*
*.........................*..*
*.........................*..*
*...***********************..*
*............................*
******************************

 
