29
*****************************************************************
*...............................................................*
*...............................................................*
*...........*...................................................*
*..........*....................................................*
*.........*.....................................................*
*........*......................................................*
*.......*.......................................................*
*.......*.......................................................*
*.......*.......................................................*
*.......*.......................................................*
*.......*.......................................................*
*.......*.......................................................*
*.......*.......................................................*
*.......*.......................................................*
*.......*.......................................................*
*.......*.......................................................*
*.......*.......................................................*
*.......*.......................................................*
*........*......................................................*
*.........*.....................................................*
*..........*....................................................*
*...........*...................................................*
*............*..................................................*
*.............*.................................................*
*...............................................................*
*...............................................................*
*...............................................................*
*****************************************************************