29
*****************************************************************
*...............................................................*
*...............................................................*
*...............................................................*
*........**************************************************.....*
*...............................................................*
*...............................................................*
*...**************************************************..........*
*...............................................................*
*...............................................................*
*........**************************************************.....*
*...............................................................*
*...............................................................*
*.......*.....................*.....................*...........*
*.......*.....................*.....................*...........*
*.......*....................*......................*...........*
*.......*...................*.......................*...........*
*.......*..................*........................*...........*
*.......*.................*.........................*...........*
*........*.................*.......................*............*
*.........*.................*.....................*.............*
*..........*.................*...................*..............*
*...........*.................*.................*...............*
*............*.................*...............*................*
*.............*...............*...............*.................*
*............................*..................................*
*...........................*...................................*
*...............................................................*
*****************************************************************