15
******************************
*............................*
*....***.....................*
*....***.....................*
*.................*..........*
*......*.......*.....*.......*
*......*.......*.....*.......*
*......*..........*..........*
*......*..*****..............*
*............................*
*...........*...*............*
*..........*.....*...........*
*.........*.......*..........*
*..................*.........*
******************************