15
******************************
*............................*
*............*...............*
*.............***............*
*............................*
*......*......*......*.......*
*......*......*......*.......*
*......*......*......*.......*
*......********...*******....*
*............................*
*...........*...*............*
*..........*.....*...........*
*.........*..**...*..........*
*....**............*.........*
******************************